     █████████████  ███                                            ██                      ███████████████████ ███           ██
 ██████████████████ ████                                           ████                      ███████████████████ ████         ███
█████       ████ ███                                            █████                                            ████       ███ 
█                        ███████████████████ ███████████████████ █████       █████        ████                   ████     ███  
  ██               ██████ ███████████████████ ███████████████████ █████ █████████████████  ████                    ████   ███   
████                ██████                                           █████ ██             ██ ████                     ████  ███    
████               ██████          █████              █████     █████                 ███ ██████████████████        ██ ███     
  █████            ██████         █████              █████      █████ ████            ███ █████████████████             ████     
     █████         ██████        █████              █████       █████ ████           ██                           ██ ████    
         █████     ██████       █████              █████        █████ ██████████████████  ████                     ███  ████   
             ████  ██████      █████              █████         █████                      ████                    ███    ████  
               ███ ██████     █████              █████          █████ ████                 ████                   ███      ████ 
████          ████ ██████                                           █████ ███              ████                  ███        ████
█████████████████ ██████ ███████████████████ ███████████████████ ████   ███         ██ ████                 ███          ████
████████████ ███  ██████ ███████████████████ ███████████████████ ██      ████████████   ███                 ██            ██






                                                           ┌──────────────────┐
                                                           │       New        │
                                                           └──────────────────┘
                                                           
                                                           ┌──────────────────┐
                                                           │      Import      │
                                                           └──────────────────┘
                                                           
                                                           ┌──────────────────┐
                                                           │     Settings     │
                                                           └──────────────────┘
                                                           
                                                           ┌──────────────────┐
                                                           │       Exit       │
                                                           └──────────────────┘
